01-04-22:
  micro             ->  text editor
  yay               ->  aur helper
  ntfs-3g           ->  ntfs parser
  dhcpcd            ->  dhcp client
  git               ->  version control
  sudo              ->  privileges
  grub & os-prober  ->  bootloader
  taskwarrior       ->  to do list
  i3-gaps           ->  window manager
  dmenu             ->  application launcher
  alacritty         ->  terminal
  btop              ->  task monitor
  xorg              ->  display server
  xinit             ->  x starter
  feh               ->  image viewer & wallpaper setter
  picom             ->  compositor
  timeshift         ->  system restore
  ly                ->  display manager
  google-chrome     ->  browser
  
01-05-22:
  rain              ->  terminal decoration
  fontpreview       ->  font viewer
  fzf               ->  fuzzy finder
  openssh           ->  ssh
  


###############################################################


To install:
  spotify-tui       ->  cli spotify client
  flameshot         ->  snapshot tool
  vlc               ->  video player
  alsa              ->  sound system
  pulseaudio        ->  sound server

  ->  file searcher
  ->  file manager
  ->  dotfile manager
  ->  system info fetch
  ->  logout ui
  ->  taskbar
  ->  alternative shell
